1111111111111
1P000E0000001
100001C0010C1
1111111111111