1111111111111
1P0000000E001
100000C000001
1111111111111
