1111111111111
1P00000000001
1000000000001
100000E000001
1000000011111
1000000000001
100000001C001
1111111111111