1111111111111111111111111111111111
1P0000000000F00C00100C00000000F001
101001110F100000001001000000000001
1E100100101011100000010000F00000C1
1111111111111111111111111111111111