1111111111111111111111111111
1CM100000000M00000000C000001
10000C000011110000000M000001
1P0000A000000000000111100001
10001111110001111110000M01C1
1000000C000001M0000000000111
1E00000M000001C00000000000M1
1111111111111111111111111111