11111111111111111111111111111111111111111111111111111111111
11111111111111111110000011111111111111111110011111111111111
11111111111101111110000011111111111100111110001111111111111
111111111110011111100C000111111111110F011110F00111111111111
1P111111111000F0000000000C00001111110M0000000C0A00000111111
101111111111000000A0F000111110111111000000F000000F000111111
10111111111100F000000000111110111111100000M0011111100111111
10111111111111111001111111111011111111111111111111100111111
10111111111111111001111111111011111111111111111111100111111
10111111111111111001111111111011111111111111111111100111111
10111111111111111CC1111111111001111111111111111111100111111
1C0000000000000F00000000111110011100000A0000011111100111101
1000011001100110000F001001111001100110110110001111110111001
1000011001100110B00010000111100100011011011000011111C110C01
1010F00000000000001F00100111000F00B000000000F000000000000C1
10000M110000110000000010011100000000110110000000F000000F001
10F0000000000A0000000000111100000000000000000000000A0000001
1111111111111111111111111111111111111111111110C111111111111
11111111111111111111111111111111111111111111100111111111111
11111111111111111111111111111111111111111111100111111111111
1001000000000100000100001111000000000000111100C0011110MM001
1001001000F0010010010010111100C01111F0001110F00000110000001
100000000000000000000000111101111111111011100010001100C0001
1001111000C0011110010010111100000000000011100101001100000C1
1M000A00000F000000000F0011110111000011101110C0100011F000001
100100100000010010010010111100000F000000111000F000110A0F001
1000000000000000F0000000111100C00000000000F0000001111000001
100F0000111100000000FA0011111111101111111111111C11111100111
1C00000011110F000000000M11111111101111111111111001111100111
10E00F001111000B0F00000011111111101111111111111001111100111
10000B001111000000000000111111111C1111111111111001111100111
1000F0000000000000F00000111110000F000111111100000000F000111
100100111F0111001111001011110011101000111111000C00000000111
1000000000000000000000000C0000011010C0011111010101010100111
11111111111111111111111111111111111111111111111111111111111