1111111111111
1P000A0000001
1000000000001
1000011100001
1000011100001
1000000000001
100000000C0E1
1111111111111