11111111111111111111
1111111A00000E111111
11111110000001111111
11111111111C11111111
11000000000000000011
11000000000000000011
11P00000000000000011
11000000000000000011
11000000000000000011
111111111C1111111111
11111110000001111111
1111111000A0C1111111
11111111111111111111