11111111111111111
1E100000000000001
10000C00001111001
1P000000001000001
10000011B01000001
1F000010001001011
10000000001C010C1
11111111111111111