1111111111111111111111111111111111
1E0000000000B00C00100C000000010MC1
10101001F0000000001001000000000001
10101MC101011100000000000B00000001
1P0000010C00C000001110000000011001
100F000000000001000000010000F11MC1
1111111111111111111111111111111111