11111111111111111111111111111111111111111111111111111111111
11111111111111111110000011111111111111111110011111111111111
111111111111C1111110000011111111111100111110001111111111111
111111111110011111100C000111111111110F011110F00111111111111
1P111111111000F0000000000C00001111110M0000000C0A00000111111
101111111111000000A0F000111110111111000000F000000F000111111
10111111111100F000000000111110111111100000C0011111100111111
10111111111111111001111111111C11111111111111111111100111111
10111111111111111CC1111111111001111111111111111111100111111
1C0000000000000F00000000111110011100000A0000011111100111101
1000011001100110000F0010C1111001100110110110001111110111001
1000011001100110B00010000111100100011011011000011111C110C01
1010F00000000000001000100111000000B000000000F000000000000C1
10000M110000110000000010C111000000001101100000000000000F001
10F0000000000A0000000000111100000000000000000000000A0000001
11111111111111111111111111111111111111111111100111111111111
10E100C00000010C000100M0111100000B0000C0111100C0011100MM001
1001001000F0010010010010111100C01111F0001110F00001100000001
1000000000000000B0000000111101111111111011100010011M00C0001
1001111000C001111001001C111100000000000011100101011000000C1
1M000A00000F0000C0000F0011110111000011101110C01001100000001
100100100000010010010010111100000F000000111000F001100A00001
1000000000000000F0000000111100C00000000000F00000011110000M1
100F0000111100000000FA0011111111101111111111111C11111100111
10000B001111000000000000111111111C1111111111111001111100111
1000F000C000000000F00000111110000F000111111100000000F000111
100100111F0111001111001011110011101000111111000C00000000111
1000000000000000000000000C0000011010C0011111010101010100111
11111111111111111111111111111111111111111111111111111111111